1
0,2,0,0
10,10
1,1,1,1,1,1,1,1,1,1
1,0,0,0,0,0,0,0,0,1
1,0,3,2,4,3,2,0,0,1
1,0,3,0,0,4,0,0,0,1
1,2,3,4,3,3,0,0,0,1
1,0,3,0,0,0,0,2,0,1
1,0,3,0,0,0,4,4,0,-1
1,0,3,3,0,0,0,0,0,-1
1,0,3,0,0,0,0,0,0,-1
1,3,3,3,3,3,3,3,3,3
