2
0,0,0,1
15,10
1,1,1,1,1,1,1,1,1,1 ,1,1,1,1,1
1,0,0,0,0,0,0,0,0,0,0,0,0,0,1
1,1,1,1,1,0,1,1,1,2,0,1,1,1,1
1,0,0,0,0,0,0,0,0,0,0,0,0,0,1
1,2,0,0,2,0,0,0,0,0,0,0,0,0,1
1,0,0,0,0,0,0,2,0,2,0,0,2,0,1
-3,0,0,0,0,0,4,4,0,1,0,4,4,0,1
-3,0,4,4,4,4,0,0,0,1,4,0,0,0,1
-3,0,0,0,0,0,0,0,0,1,0,0,0,0,1
1,4,4,4,4,4,4,4,4,4,4,4,4,4,1
