2
0,0,3,1
15,10
1,1,1,1,1,1,1,1,1,1 ,1,1,1,1,1
1,0,0,0,0,0,0,0,0,0,0,0,0,0,1
1,1,1,1,1,0,1,1,1,2,0,1,1,1,1
1,0,0,0,0,0,0,0,0,0,0,0,0,0,1
1,2,0,0,2,0,0,0,0,0,0,0,0,0,1
1,0,0,0,0,0,0,2,0,2,0,0,2,0,1
-4,0,0,0,0,0,4,4,0,1,0,4,4,0,1
-4,0,4,4,4,4,0,0,0,1,4,0,0,0,1
-4,0,0,0,0,0,0,0,0,1,0,0,0,0,1
1,-3,4,4,4,4,4,4,-3,4,4,4,4,4,1
